+--^--+     +-----+
|  E  |     |  E  |
|     |     |     |
|  I  |     |     |
+-   -+-----+-   -+
|  E  |     |     |
|                 |
|     |     |  I  |
+-----+-   -+-----+
      |     |
      |  P  |
      |     |
      +-----+