+-^-+   +---+
|   |   |   |
+- -+---+- -+
|           |
+---+- -+---+
    |   |
    +---+